41 20
###################################
#.................................#
#.............########...........##
#........########............######
#........########............######
#........########............######
#.............########............#
#.............###########.........#
#.............###########.........#
#.............###########.........#
#.............###########.........#
######............................#
######............................#
######............................#
#################............#....#
#################...........##....#
#################..........###....#
#################.........####....#
#################........#####....#
#.......#########........#####....#
#.......#########.........####....#
#.......#########..........###....#
#.......#########...........#.....#
#.......#########...........#...###
#...............................###
#...............................###
#.......#########...........#######
#.......#########..............####
###################################